"filename", "language", "C#", "XML", "JSON", "Properties", "comment", "blank", "total"
"e:\Projects\Development\Oxalate\JsonSharp\Json.cs", "C#", 542, 0, 0, 0, 1, 1, 544
"e:\Projects\Development\Oxalate\JsonSharp\JsonSharp.csproj", "XML", 0, 5, 0, 0, 0, 3, 8
"e:\Projects\Development\Oxalate\JsonSharp\bin\Debug\netcoreapp3.1\JsonSharp.deps.json", "JSON", 0, 0, 23, 0, 0, 0, 23
"e:\Projects\Development\Oxalate\JsonSharp\bin\Release\netcoreapp3.1\JsonSharp.deps.json", "JSON", 0, 0, 23, 0, 0, 0, 23
"e:\Projects\Development\Oxalate\JsonSharp\obj\Debug\netcoreapp3.1\.NETCoreApp,Version=v3.1.AssemblyAttributes.cs", "C#", 3, 0, 0, 0, 1, 1, 5
"e:\Projects\Development\Oxalate\JsonSharp\obj\Debug\netcoreapp3.1\JsonSharp.AssemblyInfo.cs", "C#", 9, 0, 0, 0, 10, 5, 24
"e:\Projects\Development\Oxalate\JsonSharp\obj\Debug\netcoreapp3.1\JsonSharp.GeneratedMSBuildEditorConfig.editorconfig", "Properties", 0, 0, 0, 3, 0, 1, 4
"e:\Projects\Development\Oxalate\JsonSharp\obj\JsonSharp.csproj.nuget.dgspec.json", "JSON", 0, 0, 62, 0, 0, 0, 62
"e:\Projects\Development\Oxalate\JsonSharp\obj\JsonSharp.csproj.nuget.g.props", "XML", 0, 18, 0, 0, 0, 0, 18
"e:\Projects\Development\Oxalate\JsonSharp\obj\JsonSharp.csproj.nuget.g.targets", "XML", 0, 6, 0, 0, 0, 0, 6
"e:\Projects\Development\Oxalate\JsonSharp\obj\Release\netcoreapp3.1\.NETCoreApp,Version=v3.1.AssemblyAttributes.cs", "C#", 3, 0, 0, 0, 1, 1, 5
"e:\Projects\Development\Oxalate\JsonSharp\obj\Release\netcoreapp3.1\JsonSharp.AssemblyInfo.cs", "C#", 9, 0, 0, 0, 10, 5, 24
"e:\Projects\Development\Oxalate\JsonSharp\obj\Release\netcoreapp3.1\JsonSharp.GeneratedMSBuildEditorConfig.editorconfig", "Properties", 0, 0, 0, 3, 0, 1, 4
"e:\Projects\Development\Oxalate\JsonSharp\obj\project.assets.json", "JSON", 0, 0, 67, 0, 0, 0, 67
"e:\Projects\Development\Oxalate\OxalateCorePlugin\OxalateCore.cs", "C#", 36, 0, 0, 0, 0, 11, 47
"e:\Projects\Development\Oxalate\OxalateCorePlugin\OxalateCorePlugin.csproj", "XML", 0, 25, 0, 0, 0, 8, 33
"e:\Projects\Development\Oxalate\OxalateCorePlugin\bin\Debug\netcoreapp3.1\OxalateCorePlugin.deps.json", "JSON", 0, 0, 63, 0, 0, 0, 63
"e:\Projects\Development\Oxalate\OxalateCorePlugin\bin\Debug\netcoreapp3.1\OxalateServer.deps.json", "JSON", 0, 0, 49, 0, 0, 0, 49
"e:\Projects\Development\Oxalate\OxalateCorePlugin\bin\Debug\netcoreapp3.1\OxalateServer.runtimeconfig.dev.json", "JSON", 0, 0, 8, 0, 0, 0, 8
"e:\Projects\Development\Oxalate\OxalateCorePlugin\bin\Debug\netcoreapp3.1\OxalateServer.runtimeconfig.json", "JSON", 0, 0, 9, 0, 0, 0, 9
"e:\Projects\Development\Oxalate\OxalateCorePlugin\bin\Debug\netcoreapp3.1\config.json", "JSON", 0, 0, 12, 0, 0, 0, 12
"e:\Projects\Development\Oxalate\OxalateCorePlugin\bin\Debug\netcoreapp3.1\zh-cn.lang.json", "JSON", 0, 0, 28, 0, 0, 5, 33
"e:\Projects\Development\Oxalate\OxalateCorePlugin\bin\Release\netcoreapp3.1\OxalateCorePlugin.deps.json", "JSON", 0, 0, 64, 0, 0, 0, 64
"e:\Projects\Development\Oxalate\OxalateCorePlugin\bin\Release\netcoreapp3.1\OxalateServer.deps.json", "JSON", 0, 0, 50, 0, 0, 0, 50
"e:\Projects\Development\Oxalate\OxalateCorePlugin\bin\Release\netcoreapp3.1\OxalateServer.runtimeconfig.dev.json", "JSON", 0, 0, 8, 0, 0, 0, 8
"e:\Projects\Development\Oxalate\OxalateCorePlugin\bin\Release\netcoreapp3.1\OxalateServer.runtimeconfig.json", "JSON", 0, 0, 9, 0, 0, 0, 9
"e:\Projects\Development\Oxalate\OxalateCorePlugin\bin\Release\netcoreapp3.1\config.json", "JSON", 0, 0, 12, 0, 0, 0, 12
"e:\Projects\Development\Oxalate\OxalateCorePlugin\bin\Release\netcoreapp3.1\zh-cn.lang.json", "JSON", 0, 0, 28, 0, 0, 5, 33
"e:\Projects\Development\Oxalate\OxalateCorePlugin\obj\Debug\netcoreapp3.1\.NETCoreApp,Version=v3.1.AssemblyAttributes.cs", "C#", 3, 0, 0, 0, 1, 1, 5
"e:\Projects\Development\Oxalate\OxalateCorePlugin\obj\Debug\netcoreapp3.1\OxalateCorePlugin.AssemblyInfo.cs", "C#", 9, 0, 0, 0, 10, 5, 24
"e:\Projects\Development\Oxalate\OxalateCorePlugin\obj\Debug\netcoreapp3.1\OxalateCorePlugin.GeneratedMSBuildEditorConfig.editorconfig", "Properties", 0, 0, 0, 3, 0, 1, 4
"e:\Projects\Development\Oxalate\OxalateCorePlugin\obj\OxalateCorePlugin.csproj.nuget.dgspec.json", "JSON", 0, 0, 245, 0, 0, 0, 245
"e:\Projects\Development\Oxalate\OxalateCorePlugin\obj\OxalateCorePlugin.csproj.nuget.g.props", "XML", 0, 18, 0, 0, 0, 0, 18
"e:\Projects\Development\Oxalate\OxalateCorePlugin\obj\OxalateCorePlugin.csproj.nuget.g.targets", "XML", 0, 6, 0, 0, 0, 0, 6
"e:\Projects\Development\Oxalate\OxalateCorePlugin\obj\Release\OxalateCorePlugin.1.0.0.nuspec", "XML", 0, 18, 0, 0, 0, 0, 18
"e:\Projects\Development\Oxalate\OxalateCorePlugin\obj\Release\netcoreapp3.1\.NETCoreApp,Version=v3.1.AssemblyAttributes.cs", "C#", 3, 0, 0, 0, 1, 1, 5
"e:\Projects\Development\Oxalate\OxalateCorePlugin\obj\Release\netcoreapp3.1\OxalateCorePlugin.AssemblyInfo.cs", "C#", 9, 0, 0, 0, 10, 5, 24
"e:\Projects\Development\Oxalate\OxalateCorePlugin\obj\Release\netcoreapp3.1\OxalateCorePlugin.GeneratedMSBuildEditorConfig.editorconfig", "Properties", 0, 0, 0, 3, 0, 1, 4
"e:\Projects\Development\Oxalate\OxalateCorePlugin\obj\project.assets.json", "JSON", 0, 0, 135, 0, 0, 0, 135
"e:\Projects\Development\Oxalate\OxalateServer\Command.cs", "C#", 28, 0, 0, 0, 6, 6, 40
"e:\Projects\Development\Oxalate\OxalateServer\IPlugin.cs", "C#", 17, 0, 0, 0, 9, 6, 32
"e:\Projects\Development\Oxalate\OxalateServer\OnlineUser.cs", "C#", 91, 0, 0, 0, 11, 11, 113
"e:\Projects\Development\Oxalate\OxalateServer\OxalateServer.csproj", "XML", 0, 19, 0, 0, 0, 5, 24
"e:\Projects\Development\Oxalate\OxalateServer\PluginAPI.cs", "C#", 49, 0, 0, 0, 15, 12, 76
"e:\Projects\Development\Oxalate\OxalateServer\PluginManager.cs", "C#", 126, 0, 0, 0, 19, 16, 161
"e:\Projects\Development\Oxalate\OxalateServer\Program.cs", "C#", 36, 0, 0, 0, 0, 10, 46
"e:\Projects\Development\Oxalate\OxalateServer\Server.Listener.cs", "C#", 163, 0, 0, 0, 0, 7, 170
"e:\Projects\Development\Oxalate\OxalateServer\Server.cs", "C#", 106, 0, 0, 0, 10, 26, 142
"e:\Projects\Development\Oxalate\OxalateServer\Translation.cs", "C#", 48, 0, 0, 0, 14, 7, 69
"e:\Projects\Development\Oxalate\OxalateServer\User.cs", "C#", 109, 0, 0, 0, 12, 22, 143
"e:\Projects\Development\Oxalate\OxalateServer\UserManager.cs", "C#", 124, 0, 0, 0, 21, 18, 163
"e:\Projects\Development\Oxalate\OxalateServer\bin\Debug\netcoreapp3.1\OxalateServer.deps.json", "JSON", 0, 0, 50, 0, 0, 0, 50
"e:\Projects\Development\Oxalate\OxalateServer\bin\Debug\netcoreapp3.1\OxalateServer.runtimeconfig.dev.json", "JSON", 0, 0, 8, 0, 0, 0, 8
"e:\Projects\Development\Oxalate\OxalateServer\bin\Debug\netcoreapp3.1\OxalateServer.runtimeconfig.json", "JSON", 0, 0, 9, 0, 0, 0, 9
"e:\Projects\Development\Oxalate\OxalateServer\bin\Debug\netcoreapp3.1\config.json", "JSON", 0, 0, 12, 0, 0, 0, 12
"e:\Projects\Development\Oxalate\OxalateServer\bin\Debug\netcoreapp3.1\zh-cn.lang.json", "JSON", 0, 0, 28, 0, 0, 5, 33
"e:\Projects\Development\Oxalate\OxalateServer\bin\Release\netcoreapp3.1\OxalateServer.deps.json", "JSON", 0, 0, 50, 0, 0, 0, 50
"e:\Projects\Development\Oxalate\OxalateServer\bin\Release\netcoreapp3.1\OxalateServer.runtimeconfig.dev.json", "JSON", 0, 0, 8, 0, 0, 0, 8
"e:\Projects\Development\Oxalate\OxalateServer\bin\Release\netcoreapp3.1\OxalateServer.runtimeconfig.json", "JSON", 0, 0, 9, 0, 0, 0, 9
"e:\Projects\Development\Oxalate\OxalateServer\bin\Release\netcoreapp3.1\config.json", "JSON", 0, 0, 12, 0, 0, 0, 12
"e:\Projects\Development\Oxalate\OxalateServer\bin\Release\netcoreapp3.1\zh-cn.lang.json", "JSON", 0, 0, 28, 0, 0, 5, 33
"e:\Projects\Development\Oxalate\OxalateServer\config.json", "JSON", 0, 0, 12, 0, 0, 0, 12
"e:\Projects\Development\Oxalate\OxalateServer\obj\Debug\netcoreapp3.1\.NETCoreApp,Version=v3.1.AssemblyAttributes.cs", "C#", 3, 0, 0, 0, 1, 1, 5
"e:\Projects\Development\Oxalate\OxalateServer\obj\Debug\netcoreapp3.1\OxalateServer.AssemblyInfo.cs", "C#", 9, 0, 0, 0, 10, 5, 24
"e:\Projects\Development\Oxalate\OxalateServer\obj\Debug\netcoreapp3.1\OxalateServer.GeneratedMSBuildEditorConfig.editorconfig", "Properties", 0, 0, 0, 3, 0, 1, 4
"e:\Projects\Development\Oxalate\OxalateServer\obj\OxalateServer.csproj.nuget.dgspec.json", "JSON", 0, 0, 181, 0, 0, 0, 181
"e:\Projects\Development\Oxalate\OxalateServer\obj\OxalateServer.csproj.nuget.g.props", "XML", 0, 18, 0, 0, 0, 0, 18
"e:\Projects\Development\Oxalate\OxalateServer\obj\OxalateServer.csproj.nuget.g.targets", "XML", 0, 6, 0, 0, 0, 0, 6
"e:\Projects\Development\Oxalate\OxalateServer\obj\Release\netcoreapp3.1\.NETCoreApp,Version=v3.1.AssemblyAttributes.cs", "C#", 3, 0, 0, 0, 1, 1, 5
"e:\Projects\Development\Oxalate\OxalateServer\obj\Release\netcoreapp3.1\OxalateServer.AssemblyInfo.cs", "C#", 9, 0, 0, 0, 10, 5, 24
"e:\Projects\Development\Oxalate\OxalateServer\obj\Release\netcoreapp3.1\OxalateServer.GeneratedMSBuildEditorConfig.editorconfig", "Properties", 0, 0, 0, 3, 0, 1, 4
"e:\Projects\Development\Oxalate\OxalateServer\obj\project.assets.json", "JSON", 0, 0, 112, 0, 0, 0, 112
"e:\Projects\Development\Oxalate\OxalateServer\zh-cn.lang.json", "JSON", 0, 0, 28, 0, 0, 5, 33
"e:\Projects\Development\Oxalate\OxalateStandard\CommandCall.cs", "C#", 69, 0, 0, 0, 18, 11, 98
"e:\Projects\Development\Oxalate\OxalateStandard\OxalateStandard.csproj", "XML", 0, 8, 0, 0, 0, 4, 12
"e:\Projects\Development\Oxalate\OxalateStandard\Packet.cs", "C#", 51, 0, 0, 0, 16, 8, 75
"e:\Projects\Development\Oxalate\OxalateStandard\ScreenIO.cs", "C#", 98, 0, 0, 0, 16, 15, 129
"e:\Projects\Development\Oxalate\OxalateStandard\StringReader.cs", "C#", 62, 0, 0, 0, 0, 2, 64
"e:\Projects\Development\Oxalate\OxalateStandard\User.cs", "C#", 81, 0, 0, 0, 9, 17, 107
"e:\Projects\Development\Oxalate\OxalateStandard\bin\Debug\netcoreapp3.1\OxalateStandard.deps.json", "JSON", 0, 0, 36, 0, 0, 0, 36
"e:\Projects\Development\Oxalate\OxalateStandard\bin\Release\netcoreapp3.1\OxalateStandard.deps.json", "JSON", 0, 0, 36, 0, 0, 0, 36
"e:\Projects\Development\Oxalate\OxalateStandard\obj\Debug\OxalateStandard.1.0.0.nuspec", "XML", 0, 15, 0, 0, 0, 0, 15
"e:\Projects\Development\Oxalate\OxalateStandard\obj\Debug\netcoreapp3.1\.NETCoreApp,Version=v3.1.AssemblyAttributes.cs", "C#", 3, 0, 0, 0, 1, 1, 5
"e:\Projects\Development\Oxalate\OxalateStandard\obj\Debug\netcoreapp3.1\OxalateStandard.AssemblyInfo.cs", "C#", 9, 0, 0, 0, 10, 5, 24
"e:\Projects\Development\Oxalate\OxalateStandard\obj\Debug\netcoreapp3.1\OxalateStandard.GeneratedMSBuildEditorConfig.editorconfig", "Properties", 0, 0, 0, 3, 0, 1, 4
"e:\Projects\Development\Oxalate\OxalateStandard\obj\OxalateStandard.csproj.nuget.dgspec.json", "JSON", 0, 0, 120, 0, 0, 0, 120
"e:\Projects\Development\Oxalate\OxalateStandard\obj\OxalateStandard.csproj.nuget.g.props", "XML", 0, 18, 0, 0, 0, 0, 18
"e:\Projects\Development\Oxalate\OxalateStandard\obj\OxalateStandard.csproj.nuget.g.targets", "XML", 0, 6, 0, 0, 0, 0, 6
"e:\Projects\Development\Oxalate\OxalateStandard\obj\Release\netcoreapp3.1\.NETCoreApp,Version=v3.1.AssemblyAttributes.cs", "C#", 3, 0, 0, 0, 1, 1, 5
"e:\Projects\Development\Oxalate\OxalateStandard\obj\Release\netcoreapp3.1\OxalateStandard.AssemblyInfo.cs", "C#", 9, 0, 0, 0, 10, 5, 24
"e:\Projects\Development\Oxalate\OxalateStandard\obj\Release\netcoreapp3.1\OxalateStandard.GeneratedMSBuildEditorConfig.editorconfig", "Properties", 0, 0, 0, 3, 0, 1, 4
"e:\Projects\Development\Oxalate\OxalateStandard\obj\project.assets.json", "JSON", 0, 0, 90, 0, 0, 0, 90
"Total", "-", 1932, 186, 1724, 24, 265, 307, 4438