"filename", "language", "C#", "JSON", "XML", "Properties", "comment", "blank", "total"
"e:\Projects\Development\Oxalate\JsonSharp\Json.cs", "C#", 542, 0, 0, 0, 1, 1, 544
"e:\Projects\Development\Oxalate\JsonSharp\JsonSharp.csproj", "XML", 0, 0, 5, 0, 0, 3, 8
"e:\Projects\Development\Oxalate\JsonSharp\bin\Debug\netcoreapp3.1\JsonSharp.deps.json", "JSON", 0, 23, 0, 0, 0, 0, 23
"e:\Projects\Development\Oxalate\JsonSharp\bin\Release\netcoreapp3.1\JsonSharp.deps.json", "JSON", 0, 23, 0, 0, 0, 0, 23
"e:\Projects\Development\Oxalate\JsonSharp\obj\Debug\netcoreapp3.1\.NETCoreApp,Version=v3.1.AssemblyAttributes.cs", "C#", 3, 0, 0, 0, 1, 1, 5
"e:\Projects\Development\Oxalate\JsonSharp\obj\Debug\netcoreapp3.1\JsonSharp.AssemblyInfo.cs", "C#", 9, 0, 0, 0, 10, 5, 24
"e:\Projects\Development\Oxalate\JsonSharp\obj\Debug\netcoreapp3.1\JsonSharp.GeneratedMSBuildEditorConfig.editorconfig", "Properties", 0, 0, 0, 3, 0, 1, 4
"e:\Projects\Development\Oxalate\JsonSharp\obj\JsonSharp.csproj.nuget.dgspec.json", "JSON", 0, 62, 0, 0, 0, 0, 62
"e:\Projects\Development\Oxalate\JsonSharp\obj\JsonSharp.csproj.nuget.g.props", "XML", 0, 0, 18, 0, 0, 0, 18
"e:\Projects\Development\Oxalate\JsonSharp\obj\JsonSharp.csproj.nuget.g.targets", "XML", 0, 0, 6, 0, 0, 0, 6
"e:\Projects\Development\Oxalate\JsonSharp\obj\Release\netcoreapp3.1\.NETCoreApp,Version=v3.1.AssemblyAttributes.cs", "C#", 3, 0, 0, 0, 1, 1, 5
"e:\Projects\Development\Oxalate\JsonSharp\obj\Release\netcoreapp3.1\JsonSharp.AssemblyInfo.cs", "C#", 9, 0, 0, 0, 10, 5, 24
"e:\Projects\Development\Oxalate\JsonSharp\obj\Release\netcoreapp3.1\JsonSharp.GeneratedMSBuildEditorConfig.editorconfig", "Properties", 0, 0, 0, 3, 0, 1, 4
"e:\Projects\Development\Oxalate\JsonSharp\obj\project.assets.json", "JSON", 0, 67, 0, 0, 0, 0, 67
"e:\Projects\Development\Oxalate\OxalateClient-GUI\ConnectDialog.Designer.cs", "C#", 93, 0, 0, 0, 29, 7, 129
"e:\Projects\Development\Oxalate\OxalateClient-GUI\ConnectDialog.cs", "C#", 109, 0, 0, 0, 0, 8, 117
"e:\Projects\Development\Oxalate\OxalateClient-GUI\MainForm.Designer.cs", "C#", 91, 0, 0, 0, 35, 9, 135
"e:\Projects\Development\Oxalate\OxalateClient-GUI\MainForm.cs", "C#", 53, 0, 0, 0, 0, 10, 63
"e:\Projects\Development\Oxalate\OxalateClient-GUI\OxalateClient-GUI.csproj", "XML", 0, 0, 11, 0, 0, 3, 14
"e:\Projects\Development\Oxalate\OxalateClient-GUI\Preference.cs", "C#", 91, 0, 0, 0, 3, 7, 101
"e:\Projects\Development\Oxalate\OxalateClient-GUI\Program.cs", "C#", 26, 0, 0, 0, 3, 2, 31
"e:\Projects\Development\Oxalate\OxalateClient-GUI\TextBoxIO.cs", "C#", 67, 0, 0, 0, 0, 6, 73
"e:\Projects\Development\Oxalate\OxalateClient-GUI\bin\Debug\netcoreapp3.1\OxalateClient-GUI.deps.json", "JSON", 0, 68, 0, 0, 0, 0, 68
"e:\Projects\Development\Oxalate\OxalateClient-GUI\bin\Debug\netcoreapp3.1\OxalateClient-GUI.runtimeconfig.dev.json", "JSON", 0, 8, 0, 0, 0, 0, 8
"e:\Projects\Development\Oxalate\OxalateClient-GUI\bin\Debug\netcoreapp3.1\OxalateClient-GUI.runtimeconfig.json", "JSON", 0, 9, 0, 0, 0, 0, 9
"e:\Projects\Development\Oxalate\OxalateClient-GUI\bin\Debug\netcoreapp3.1\config.json", "JSON", 0, 93, 0, 0, 0, 0, 93
"e:\Projects\Development\Oxalate\OxalateClient-GUI\obj\Debug\netcoreapp3.1\.NETCoreApp,Version=v3.1.AssemblyAttributes.cs", "C#", 3, 0, 0, 0, 1, 1, 5
"e:\Projects\Development\Oxalate\OxalateClient-GUI\obj\Debug\netcoreapp3.1\OxalateClient-GUI.AssemblyInfo.cs", "C#", 9, 0, 0, 0, 10, 5, 24
"e:\Projects\Development\Oxalate\OxalateClient-GUI\obj\Debug\netcoreapp3.1\OxalateClient-GUI.GeneratedMSBuildEditorConfig.editorconfig", "Properties", 0, 0, 0, 3, 0, 1, 4
"e:\Projects\Development\Oxalate\OxalateClient-GUI\obj\Debug\netcoreapp3.1\OxalateClient-GUI.designer.deps.json", "JSON", 0, 11, 0, 0, 0, 0, 11
"e:\Projects\Development\Oxalate\OxalateClient-GUI\obj\Debug\netcoreapp3.1\OxalateClient-GUI.designer.runtimeconfig.json", "JSON", 0, 16, 0, 0, 0, 0, 16
"e:\Projects\Development\Oxalate\OxalateClient-GUI\obj\OxalateClient-GUI.csproj.nuget.dgspec.json", "JSON", 0, 242, 0, 0, 0, 0, 242
"e:\Projects\Development\Oxalate\OxalateClient-GUI\obj\OxalateClient-GUI.csproj.nuget.g.props", "XML", 0, 0, 18, 0, 0, 0, 18
"e:\Projects\Development\Oxalate\OxalateClient-GUI\obj\OxalateClient-GUI.csproj.nuget.g.targets", "XML", 0, 0, 6, 0, 0, 0, 6
"e:\Projects\Development\Oxalate\OxalateClient-GUI\obj\project.assets.json", "JSON", 0, 130, 0, 0, 0, 0, 130
"e:\Projects\Development\Oxalate\OxalateClient\Client.cs", "C#", 134, 0, 0, 0, 35, 18, 187
"e:\Projects\Development\Oxalate\OxalateClient\ClientKeepAlive.cs", "C#", 36, 0, 0, 0, 0, 4, 40
"e:\Projects\Development\Oxalate\OxalateClient\ClientListener.cs", "C#", 49, 0, 0, 0, 0, 4, 53
"e:\Projects\Development\Oxalate\OxalateClient\Events.cs", "C#", 48, 0, 0, 0, 0, 7, 55
"e:\Projects\Development\Oxalate\OxalateClient\OxalateClient.csproj", "XML", 0, 0, 9, 0, 0, 4, 13
"e:\Projects\Development\Oxalate\OxalateClient\bin\Debug\netcoreapp3.1\OxalateClient.deps.json", "JSON", 0, 50, 0, 0, 0, 0, 50
"e:\Projects\Development\Oxalate\OxalateClient\obj\Debug\netcoreapp3.1\.NETCoreApp,Version=v3.1.AssemblyAttributes.cs", "C#", 3, 0, 0, 0, 1, 1, 5
"e:\Projects\Development\Oxalate\OxalateClient\obj\Debug\netcoreapp3.1\OxalateClient.AssemblyInfo.cs", "C#", 9, 0, 0, 0, 10, 5, 24
"e:\Projects\Development\Oxalate\OxalateClient\obj\Debug\netcoreapp3.1\OxalateClient.GeneratedMSBuildEditorConfig.editorconfig", "Properties", 0, 0, 0, 3, 0, 1, 4
"e:\Projects\Development\Oxalate\OxalateClient\obj\OxalateClient.csproj.nuget.dgspec.json", "JSON", 0, 181, 0, 0, 0, 0, 181
"e:\Projects\Development\Oxalate\OxalateClient\obj\OxalateClient.csproj.nuget.g.props", "XML", 0, 0, 18, 0, 0, 0, 18
"e:\Projects\Development\Oxalate\OxalateClient\obj\OxalateClient.csproj.nuget.g.targets", "XML", 0, 0, 6, 0, 0, 0, 6
"e:\Projects\Development\Oxalate\OxalateClient\obj\project.assets.json", "JSON", 0, 112, 0, 0, 0, 0, 112
"e:\Projects\Development\Oxalate\OxalateCorePlugin\OxalateCore.cs", "C#", 36, 0, 0, 0, 0, 11, 47
"e:\Projects\Development\Oxalate\OxalateCorePlugin\OxalateCorePlugin.csproj", "XML", 0, 0, 25, 0, 0, 8, 33
"e:\Projects\Development\Oxalate\OxalateCorePlugin\bin\Debug\netcoreapp3.1\OxalateCorePlugin.deps.json", "JSON", 0, 65, 0, 0, 0, 0, 65
"e:\Projects\Development\Oxalate\OxalateCorePlugin\bin\Debug\netcoreapp3.1\OxalateServer.deps.json", "JSON", 0, 50, 0, 0, 0, 0, 50
"e:\Projects\Development\Oxalate\OxalateCorePlugin\bin\Debug\netcoreapp3.1\OxalateServer.runtimeconfig.dev.json", "JSON", 0, 8, 0, 0, 0, 0, 8
"e:\Projects\Development\Oxalate\OxalateCorePlugin\bin\Debug\netcoreapp3.1\OxalateServer.runtimeconfig.json", "JSON", 0, 9, 0, 0, 0, 0, 9
"e:\Projects\Development\Oxalate\OxalateCorePlugin\bin\Debug\netcoreapp3.1\config.json", "JSON", 0, 12, 0, 0, 0, 0, 12
"e:\Projects\Development\Oxalate\OxalateCorePlugin\bin\Debug\netcoreapp3.1\zh-cn.lang.json", "JSON", 0, 28, 0, 0, 0, 5, 33
"e:\Projects\Development\Oxalate\OxalateCorePlugin\bin\Release\netcoreapp3.1\OxalateCorePlugin.deps.json", "JSON", 0, 64, 0, 0, 0, 0, 64
"e:\Projects\Development\Oxalate\OxalateCorePlugin\bin\Release\netcoreapp3.1\OxalateServer.deps.json", "JSON", 0, 50, 0, 0, 0, 0, 50
"e:\Projects\Development\Oxalate\OxalateCorePlugin\bin\Release\netcoreapp3.1\OxalateServer.runtimeconfig.dev.json", "JSON", 0, 8, 0, 0, 0, 0, 8
"e:\Projects\Development\Oxalate\OxalateCorePlugin\bin\Release\netcoreapp3.1\OxalateServer.runtimeconfig.json", "JSON", 0, 9, 0, 0, 0, 0, 9
"e:\Projects\Development\Oxalate\OxalateCorePlugin\bin\Release\netcoreapp3.1\config.json", "JSON", 0, 12, 0, 0, 0, 0, 12
"e:\Projects\Development\Oxalate\OxalateCorePlugin\bin\Release\netcoreapp3.1\zh-cn.lang.json", "JSON", 0, 28, 0, 0, 0, 5, 33
"e:\Projects\Development\Oxalate\OxalateCorePlugin\obj\Debug\netcoreapp3.1\.NETCoreApp,Version=v3.1.AssemblyAttributes.cs", "C#", 3, 0, 0, 0, 1, 1, 5
"e:\Projects\Development\Oxalate\OxalateCorePlugin\obj\Debug\netcoreapp3.1\OxalateCorePlugin.AssemblyInfo.cs", "C#", 9, 0, 0, 0, 10, 5, 24
"e:\Projects\Development\Oxalate\OxalateCorePlugin\obj\Debug\netcoreapp3.1\OxalateCorePlugin.GeneratedMSBuildEditorConfig.editorconfig", "Properties", 0, 0, 0, 3, 0, 1, 4
"e:\Projects\Development\Oxalate\OxalateCorePlugin\obj\OxalateCorePlugin.csproj.nuget.dgspec.json", "JSON", 0, 245, 0, 0, 0, 0, 245
"e:\Projects\Development\Oxalate\OxalateCorePlugin\obj\OxalateCorePlugin.csproj.nuget.g.props", "XML", 0, 0, 18, 0, 0, 0, 18
"e:\Projects\Development\Oxalate\OxalateCorePlugin\obj\OxalateCorePlugin.csproj.nuget.g.targets", "XML", 0, 0, 6, 0, 0, 0, 6
"e:\Projects\Development\Oxalate\OxalateCorePlugin\obj\Release\OxalateCorePlugin.1.0.0.nuspec", "XML", 0, 0, 18, 0, 0, 0, 18
"e:\Projects\Development\Oxalate\OxalateCorePlugin\obj\Release\netcoreapp3.1\.NETCoreApp,Version=v3.1.AssemblyAttributes.cs", "C#", 3, 0, 0, 0, 1, 1, 5
"e:\Projects\Development\Oxalate\OxalateCorePlugin\obj\Release\netcoreapp3.1\OxalateCorePlugin.AssemblyInfo.cs", "C#", 9, 0, 0, 0, 10, 5, 24
"e:\Projects\Development\Oxalate\OxalateCorePlugin\obj\Release\netcoreapp3.1\OxalateCorePlugin.GeneratedMSBuildEditorConfig.editorconfig", "Properties", 0, 0, 0, 3, 0, 1, 4
"e:\Projects\Development\Oxalate\OxalateCorePlugin\obj\project.assets.json", "JSON", 0, 135, 0, 0, 0, 0, 135
"e:\Projects\Development\Oxalate\OxalateServer\Command.cs", "C#", 28, 0, 0, 0, 6, 6, 40
"e:\Projects\Development\Oxalate\OxalateServer\IPlugin.cs", "C#", 17, 0, 0, 0, 9, 6, 32
"e:\Projects\Development\Oxalate\OxalateServer\OnlineUser.cs", "C#", 108, 0, 0, 0, 12, 11, 131
"e:\Projects\Development\Oxalate\OxalateServer\OxalateServer.csproj", "XML", 0, 0, 19, 0, 0, 5, 24
"e:\Projects\Development\Oxalate\OxalateServer\PluginAPI.cs", "C#", 67, 0, 0, 0, 24, 15, 106
"e:\Projects\Development\Oxalate\OxalateServer\PluginManager.cs", "C#", 126, 0, 0, 0, 23, 16, 165
"e:\Projects\Development\Oxalate\OxalateServer\Program.cs", "C#", 37, 0, 0, 0, 0, 10, 47
"e:\Projects\Development\Oxalate\OxalateServer\Server.Commands.cs", "C#", 15, 0, 0, 0, 0, 3, 18
"e:\Projects\Development\Oxalate\OxalateServer\Server.Listener.cs", "C#", 185, 0, 0, 0, 0, 7, 192
"e:\Projects\Development\Oxalate\OxalateServer\Server.Message.cs", "C#", 19, 0, 0, 0, 6, 3, 28
"e:\Projects\Development\Oxalate\OxalateServer\Server.Users.cs", "C#", 124, 0, 0, 0, 21, 18, 163
"e:\Projects\Development\Oxalate\OxalateServer\Server.cs", "C#", 113, 0, 0, 0, 13, 28, 154
"e:\Projects\Development\Oxalate\OxalateServer\bin\Debug\netcoreapp3.1\OxalateServer.deps.json", "JSON", 0, 50, 0, 0, 0, 0, 50
"e:\Projects\Development\Oxalate\OxalateServer\bin\Debug\netcoreapp3.1\OxalateServer.runtimeconfig.dev.json", "JSON", 0, 8, 0, 0, 0, 0, 8
"e:\Projects\Development\Oxalate\OxalateServer\bin\Debug\netcoreapp3.1\OxalateServer.runtimeconfig.json", "JSON", 0, 9, 0, 0, 0, 0, 9
"e:\Projects\Development\Oxalate\OxalateServer\bin\Debug\netcoreapp3.1\config.json", "JSON", 0, 13, 0, 0, 0, 0, 13
"e:\Projects\Development\Oxalate\OxalateServer\bin\Debug\netcoreapp3.1\zh-cn.lang.json", "JSON", 0, 31, 0, 0, 0, 6, 37
"e:\Projects\Development\Oxalate\OxalateServer\bin\Release\netcoreapp3.1\OxalateServer.deps.json", "JSON", 0, 50, 0, 0, 0, 0, 50
"e:\Projects\Development\Oxalate\OxalateServer\bin\Release\netcoreapp3.1\OxalateServer.runtimeconfig.dev.json", "JSON", 0, 8, 0, 0, 0, 0, 8
"e:\Projects\Development\Oxalate\OxalateServer\bin\Release\netcoreapp3.1\OxalateServer.runtimeconfig.json", "JSON", 0, 9, 0, 0, 0, 0, 9
"e:\Projects\Development\Oxalate\OxalateServer\bin\Release\netcoreapp3.1\config.json", "JSON", 0, 12, 0, 0, 0, 0, 12
"e:\Projects\Development\Oxalate\OxalateServer\bin\Release\netcoreapp3.1\zh-cn.lang.json", "JSON", 0, 28, 0, 0, 0, 5, 33
"e:\Projects\Development\Oxalate\OxalateServer\config.json", "JSON", 0, 13, 0, 0, 0, 0, 13
"e:\Projects\Development\Oxalate\OxalateServer\obj\Debug\netcoreapp3.1\.NETCoreApp,Version=v3.1.AssemblyAttributes.cs", "C#", 3, 0, 0, 0, 1, 1, 5
"e:\Projects\Development\Oxalate\OxalateServer\obj\Debug\netcoreapp3.1\OxalateServer.AssemblyInfo.cs", "C#", 9, 0, 0, 0, 10, 5, 24
"e:\Projects\Development\Oxalate\OxalateServer\obj\Debug\netcoreapp3.1\OxalateServer.GeneratedMSBuildEditorConfig.editorconfig", "Properties", 0, 0, 0, 3, 0, 1, 4
"e:\Projects\Development\Oxalate\OxalateServer\obj\OxalateServer.csproj.nuget.dgspec.json", "JSON", 0, 181, 0, 0, 0, 0, 181
"e:\Projects\Development\Oxalate\OxalateServer\obj\OxalateServer.csproj.nuget.g.props", "XML", 0, 0, 18, 0, 0, 0, 18
"e:\Projects\Development\Oxalate\OxalateServer\obj\OxalateServer.csproj.nuget.g.targets", "XML", 0, 0, 6, 0, 0, 0, 6
"e:\Projects\Development\Oxalate\OxalateServer\obj\Release\netcoreapp3.1\.NETCoreApp,Version=v3.1.AssemblyAttributes.cs", "C#", 3, 0, 0, 0, 1, 1, 5
"e:\Projects\Development\Oxalate\OxalateServer\obj\Release\netcoreapp3.1\OxalateServer.AssemblyInfo.cs", "C#", 9, 0, 0, 0, 10, 5, 24
"e:\Projects\Development\Oxalate\OxalateServer\obj\Release\netcoreapp3.1\OxalateServer.GeneratedMSBuildEditorConfig.editorconfig", "Properties", 0, 0, 0, 3, 0, 1, 4
"e:\Projects\Development\Oxalate\OxalateServer\obj\project.assets.json", "JSON", 0, 112, 0, 0, 0, 0, 112
"e:\Projects\Development\Oxalate\OxalateServer\zh-cn.lang.json", "JSON", 0, 31, 0, 0, 0, 6, 37
"e:\Projects\Development\Oxalate\OxalateStandard\CommandCall.cs", "C#", 68, 0, 0, 0, 18, 11, 97
"e:\Projects\Development\Oxalate\OxalateStandard\OxalateStandard.csproj", "XML", 0, 0, 8, 0, 0, 4, 12
"e:\Projects\Development\Oxalate\OxalateStandard\Packet.cs", "C#", 60, 0, 0, 0, 16, 8, 84
"e:\Projects\Development\Oxalate\OxalateStandard\ScreenIO.cs", "C#", 98, 0, 0, 0, 16, 14, 128
"e:\Projects\Development\Oxalate\OxalateStandard\StringReader.cs", "C#", 62, 0, 0, 0, 0, 2, 64
"e:\Projects\Development\Oxalate\OxalateStandard\Translation.cs", "C#", 47, 0, 0, 0, 14, 7, 68
"e:\Projects\Development\Oxalate\OxalateStandard\User.cs", "C#", 53, 0, 0, 0, 9, 9, 71
"e:\Projects\Development\Oxalate\OxalateStandard\bin\Debug\netcoreapp3.1\OxalateStandard.deps.json", "JSON", 0, 36, 0, 0, 0, 0, 36
"e:\Projects\Development\Oxalate\OxalateStandard\bin\Release\netcoreapp3.1\OxalateStandard.deps.json", "JSON", 0, 36, 0, 0, 0, 0, 36
"e:\Projects\Development\Oxalate\OxalateStandard\obj\Debug\OxalateStandard.1.0.0.nuspec", "XML", 0, 0, 15, 0, 0, 0, 15
"e:\Projects\Development\Oxalate\OxalateStandard\obj\Debug\netcoreapp3.1\.NETCoreApp,Version=v3.1.AssemblyAttributes.cs", "C#", 3, 0, 0, 0, 1, 1, 5
"e:\Projects\Development\Oxalate\OxalateStandard\obj\Debug\netcoreapp3.1\OxalateStandard.AssemblyInfo.cs", "C#", 9, 0, 0, 0, 10, 5, 24
"e:\Projects\Development\Oxalate\OxalateStandard\obj\Debug\netcoreapp3.1\OxalateStandard.GeneratedMSBuildEditorConfig.editorconfig", "Properties", 0, 0, 0, 3, 0, 1, 4
"e:\Projects\Development\Oxalate\OxalateStandard\obj\OxalateStandard.csproj.nuget.dgspec.json", "JSON", 0, 120, 0, 0, 0, 0, 120
"e:\Projects\Development\Oxalate\OxalateStandard\obj\OxalateStandard.csproj.nuget.g.props", "XML", 0, 0, 18, 0, 0, 0, 18
"e:\Projects\Development\Oxalate\OxalateStandard\obj\OxalateStandard.csproj.nuget.g.targets", "XML", 0, 0, 6, 0, 0, 0, 6
"e:\Projects\Development\Oxalate\OxalateStandard\obj\Release\netcoreapp3.1\.NETCoreApp,Version=v3.1.AssemblyAttributes.cs", "C#", 3, 0, 0, 0, 1, 1, 5
"e:\Projects\Development\Oxalate\OxalateStandard\obj\Release\netcoreapp3.1\OxalateStandard.AssemblyInfo.cs", "C#", 9, 0, 0, 0, 10, 5, 24
"e:\Projects\Development\Oxalate\OxalateStandard\obj\Release\netcoreapp3.1\OxalateStandard.GeneratedMSBuildEditorConfig.editorconfig", "Properties", 0, 0, 0, 3, 0, 1, 4
"e:\Projects\Development\Oxalate\OxalateStandard\obj\project.assets.json", "JSON", 0, 90, 0, 0, 0, 0, 90
"Total", "-", 2722, 2655, 254, 30, 403, 392, 6456